char map[][] = {
	"####################",
	"#      #           #",
	"#      #           #",
	"#      #           #",
	"#      #      #    #",
	"#      #      #    #",
	"#             #    #",
	"#             #    #",
	"#             #    #",
	"####################"
};

"####################",
"#      #           #",
"# S    #           #",
"#      #           #",
"#      #      #    #",
"#      #      #    #",
"#             #    #",
"#             #    #",
"#             # E  #",
"####################"